11 20
48 88 34 94 102 53 1 104 0 86 65 28 0 60 1 65 106 82 19 12
54 86 34 68 75 91 12 53 49 8 107 77 96 83 49 23 23 4 78 109
37 37 54 24 24 62 28 101 44 8 33 33 77 91 81 89 81 4 50 19
43 43 103 85 62 61 103 67 84 67 75 44 38 38 56 27 27 45 18 22
40 40 29 29 48 41 11 26 52 59 35 100 70 5 79 56 107 90 18 25
60 109 106 85 13 13 11 79 105 61 30 30 6 5 6 58 59 10 45 50
82 76 100 108 92 68 26 41 14 52 35 31 78 31 70 97 108 10 95 58
15 47 39 39 102 55 55 97 14 73 94 90 95 80 57 89 99 84 25 21
36 2 2 71 71 32 32 87 9 9 74 74 88 7 7 83 64 63 64 21
17 69 36 99 76 93 98 51 101 57 73 46 93 98 16 72 92 20 66 22
15 17 47 42 96 87 72 51 105 3 69 42 3 80 16 66 46 20 104 63