11 20
104 83 76 50 88 105 71 85 44 84 21 26 95 0 71 26 0 93 37 86
76 24 24 89 33 13 13 72 44 78 37 69 62 21 106 107 97 81 74 3
34 57 57 45 33 90 51 87 98 69 50 85 62 91 54 14 73 20 60 81
34 49 104 83 45 6 6 89 88 84 108 96 63 63 40 14 74 20 60 98
103 93 29 82 61 56 28 28 36 36 30 66 100 52 32 99 101 96 8 8
1 1 15 72 41 22 22 95 51 9 9 61 101 75 32 31 73 106 94 109
10 29 78 2 2 38 67 67 91 99 30 48 48 75 40 27 52 35 68 108
10 49 66 38 41 59 77 17 17 87 79 80 92 70 70 5 31 7 7 94
102 58 58 56 39 39 47 92 53 43 53 105 46 46 5 4 4 27 11 11
42 42 103 65 18 47 25 25 65 16 77 102 64 79 19 55 54 64 35 3
15 100 59 109 18 12 86 97 12 16 82 23 43 90 19 23 80 55 68 107