8 8
18 29 30 21 8 1 17 7
21 29 28 2 8 32 0 1
17 28 18 17 32 2 13 14
6 9 2 17 2 2 18 28
2 13 18 0 18 30 18 6
13 9 7 7 28 9 18 23
18 7 7 14 9 18 18 7
8 13 6 14 8 23 6 14