11 20
31 18 9 12 12 24 9 26 18 2 9 32 29 18 26 1 32 32 9 28
24 28 12 30 18 11 22 31 28 21 21 12 12 5 30 1 32 15 32 18
26 22 22 17 21 21 24 29 11 8 10 8 25 25 30 21 15 15 30 30
19 26 30 28 25 25 11 1 19 19 10 1 18 25 2 24 3 4 7 30
24 13 11 11 27 24 4 4 2 1 18 27 15 16 20 24 4 1 1 9
11 19 5 8 8 18 27 27 15 3 19 28 15 32 20 18 5 32 7 32
25 12 30 24 7 24 32 32 15 15 1 1 28 1 1 32 5 28 22 18
19 7 3 9 22 24 9 29 22 3 28 31 22 30 28 3 21 20 15 9
13 23 3 30 22 8 17 3 22 3 27 27 21 24 12 22 28 6 20 20
11 25 24 8 16 20 26 26 31 32 7 20 13 13 12 24 0 0 23 1
15 6 4 22 11 7 9 29 4 29 29 7 2 22 24 21 7 20 9 25