10 12
30 2 12 27 25 27 23 26 0 31 4 4
13 26 17 7 23 2 28 29 15 15 7 0
13 18 17 30 15 23 4 5 29 11 11 26
23 30 18 15 0 4 26 5 23 23 11 23
23 30 28 0 30 18 31 20 31 12 30 26
23 25 30 0 30 18 10 10 24 20 8 29
10 27 27 10 26 29 24 31 28 29 8 29
9 20 11 9 26 25 31 20 20 20 7 0
31 21 21 27 23 30 30 28 8 30 23 26
25 27 9 8 7 30 5 23 5 2 9 2