8 15
3 26 2 22 5 31 11 22 3 9 5 11 11 2 26
7 27 14 32 13 31 10 14 14 27 5 4 24 24 23
13 16 14 16 17 27 12 12 6 28 7 24 4 27 31
15 4 32 6 30 30 0 31 23 23 19 19 26 6 19
10 10 22 22 26 23 0 7 7 20 4 19 11 6 11
32 13 27 27 18 10 20 7 12 16 16 8 8 4 9
32 15 28 18 20 11 13 19 12 24 22 11 4 22 23
17 27 29 4 20 11 5 19 7 4 27 28 23 29 28